Rosy mist departs around a falling man. The edge of the canyon's shadow dances along uneven crags, casting a sharp shadow between lines of scarlet and thulian, traced down through cracks by a man, presently crumpled into an exposed ravine. Onlookers squirm at the sight; some are much more moved by the spectacle. Before too long (and after the catwalk underwent a thorough scrubbing down by the real heroes in this situation), the crowd thinned. Authorities came and went; nobody could have seen who shot him. Many began to leave the platform, in disgust or boredom.

One girl didn't leave. She stood, transfixed by the coral and mauve stains on the rocks, oblivious to the sunset of rainbows falling on the canyon. Evening subdued the canyon's vibrance, but she still had them glowing within her: She had his colors in her blood, now, too. From that evening on, varicolored palettes of light would race through her mind, and she would keep their tones and shades for the rest of her life.

"Adaline, let's go."

Getting impatient, Gentiana prodded at her friend. She'd given Ada plenty of time to get out of her little trance, and it was getting late. "Come on, Adaline, we have to go." Adaline absentmindedly stumbled away with her, occasionally glancing up, at the ragged moon, blankly watching it find it's path up through the sky.

What will your name be?

I beg your pardon?

What will your name be?

>Ada
Are you male or female?

* * *

I beg your pardon?

>l
Your Quarters
It's a standard-issue dwelling, designed for the unusually harsh conditions of the Terrace. It is made of many alloys of metal, and is joisted by slender titanium trusses. It's defining feature is the central, dome-shaped foyer from which the more traditional, rectangular rooms branch off.Your tattered backpack is here. You typically don't leave home without it. You've been using an old-style drafting table as a desk for as long as you've needed a desk. It's edged with a dented but sturdy aluminum frame. It has a hefty steel pivot, its arc stretching 135° or more. Four triangularly trussed legs extend to spherical rubber feet which match perfectly your dented floor. Your door leads out, and you can see it's bright outside through it's circular window. Curved rails carry it a few degrees around the inside of the dome. 

Time passes.

You shudder awake. If you were a bit more careful (rather, if the room was spinning even a little bit slower), you might've dodged the doorframe on your way to your porcelain friend. You won't remember why your temple hurts. You begin to get up, but the visceral stack of mistakes you're popping off keep you down. You stagger to your feet, swaying a bit as you try to lock eyes with yourself in the mirror. Your eyes haven't focused yet, and you consider that you might not want to see yourself like this.

Do you look at yourself?

>no
Good call. You're already on the verge of impending mental collapse; you don't need to feel worse. You avoid the mirror like it's a basilisk until you're overabundantly cleaner.
You make an earnest attempt to clean up. There's a lot of water and scraping, and it doesn't go well. You put concealer literally everywhere. You're just going to have to deal with the fact that there are colors on your face today that simply can't be corrected. Long pants are a foregone conclusion. You consider the surfeit of ways that mascara could go horribly wrong, and without a second thought you walk out of the room to your dresser. Nicer clothes will at least allow you to masquerade as a well-put-together human being.

I beg your pardon?

>z
Time passes.

>look
Your Quarters
You return home. It's a standard-issue dwelling, designed for the unusually harsh conditions of the Terrace. It is made of many alloys of metal, and is joisted by slender titanium trusses. It's defining feature is the central, dome-shaped foyer from which the more traditional, rectangular rooms branch off.Your tattered backpack is here. You typically don't leave home without it. You've been using an old-style drafting table as a desk for as long as you've needed a desk. It's edged with a dented but sturdy aluminum frame. It has a hefty steel pivot, its arc stretching 135° or more. Four triangularly trussed legs extend to spherical rubber feet which match perfectly your dented floor. Your door leads out, and you can see it's bright outside through it's circular window. Curved rails carry it a few degrees around the inside of the dome.

* * *

What will your name be?

>Ada
Are you male or female?

* * *

I beg your pardon?

I beg your pardon?

>z
Time passes.

You shudder awake. If you were a bit more careful (rather, if the room was spinning even a little bit slower), you might've dodged the doorframe on your way to your porcelain friend. You won't remember why your temple hurts. You begin to get up, but the visceral stack of mistakes you're popping off keep you down. You stagger to your feet, swaying a bit as you try to lock eyes with yourself in the mirror. Your eyes haven't focused yet, and you consider that you might not want to see yourself like this.

Do you look at yourself?

>n
Good call. You're already on the verge of impending mental collapse; you don't need to feel worse. You avoid the mirror like it's a basilisk until you're overabundantly cleaner.
You make an earnest attempt to clean up. There's a lot of water and scraping, and it doesn't go well. You put concealer literally everywhere. You're just going to have to deal with the fact that there are colors on your face today that simply can't be corrected. Long pants are a foregone conclusion. You consider the surfeit of ways that mascara could go horribly wrong, and without a second thought you walk out of the room to your dresser. Nicer clothes will at least allow you to masquerade as a well-put-together human being.

>looi
That's not a verb I recognise.

>look
Your Quarters
It's a standard-issue dwelling, designed for the unusually harsh conditions of the Terrace. It is made of many alloys of metal, and is joisted by slender titanium trusses. It's defining feature is the central, dome-shaped foyer from which the more traditional, rectangular rooms branch off.Your tattered backpack is here. You typically don't leave home without it. You've been using an old-style drafting table as a desk for as long as you've needed a desk. It's edged with a dented but sturdy aluminum frame. It has a hefty steel pivot, its arc stretching 135° or more. Four triangularly trussed legs extend to spherical rubber feet which match perfectly your dented floor. Your door leads out, and you can see it's bright outside through it's circular window. Curved rails carry it a few degrees around the inside of the dome.

* * *

I beg your pardon?

>zl
That's not a verb I recognise.

>z
Time passes.

>look
Your Quarters
It's a standard-issue dwelling, designed for the unusually harsh conditions of the Terrace. It is made of many alloys of metal, and is joisted by slender titanium trusses. It's defining feature is the central, dome-shaped foyer from which the more traditional, rectangular rooms branch off.Your tattered backpack is here. You typically don't leave home without it. You've been using an old-style drafting table as a desk for as long as you've needed a desk. It's edged with a dented but sturdy aluminum frame. It has a hefty steel pivot, its arc stretching 135° or more. Four triangularly trussed legs extend to spherical rubber feet which match perfectly your dented floor. Your door leads out, and you can see it's bright outside through it's circular window. Curved rails carry it a few degrees around the inside of the dome.

>z
Time passes.

* * *

I beg your pardon?

>look
Your Quarters
It's a standard-issue dwelling, designed for the unusually harsh conditions of the Terrace. It is made of many alloys of metal, and is joisted by slender titanium trusses. It's defining feature is the central, dome-shaped foyer from which the more traditional, rectangular rooms branch off.Your tattered backpack is here. You typically don't leave home without it. You've been using an old-style drafting table as a desk for as long as you've needed a desk. It's edged with a dented but sturdy aluminum frame. It has a hefty steel pivot, its arc stretching 135° or more. Four triangularly trussed legs extend to spherical rubber feet which match perfectly your dented floor. Your door leads out, and you can see it's bright outside through it's circular window. Curved rails carry it a few degrees around the inside of the dome. 

You shudder awake. If you were a bit more careful (rather, if the room was spinning even a little bit slower), you might've dodged the doorframe on your way to your porcelain friend. You won't remember why your temple hurts. You begin to get up, but the visceral stack of mistakes you're popping off keep you down. You stagger to your feet, swaying a bit as you try to lock eyes with yourself in the mirror. Your eyes haven't focused yet, and you consider that you might not want to see yourself like this.

Do you look at yourself?

>n
Good call. You're already on the verge of impending mental collapse; you don't need to feel worse. You avoid the mirror like it's a basilisk until you're overabundantly cleaner.
You make an earnest attempt to clean up. There's a lot of water and scraping, and it doesn't go well. You put concealer literally everywhere. You're just going to have to deal with the fact that there are colors on your face today that simply can't be corrected. Long pants are a foregone conclusion. You consider the surfeit of ways that mascara could go horribly wrong, and without a second thought you walk out of the room to your dresser. Nicer clothes will at least allow you to masquerade as a well-put-together human being.

>l
Your Quarters
You return home. It's a standard-issue dwelling, designed for the unusually harsh conditions of the Terrace. It is made of many alloys of metal, and is joisted by slender titanium trusses. It's defining feature is the central, dome-shaped foyer from which the more traditional, rectangular rooms branch off.Your tattered backpack is here. You typically don't leave home without it. You've been using an old-style drafting table as a desk for as long as you've needed a desk. It's edged with a dented but sturdy aluminum frame. It has a hefty steel pivot, its arc stretching 135° or more. Four triangularly trussed legs extend to spherical rubber feet which match perfectly your dented floor. Your door leads out, and you can see it's bright outside through it's circular window. Curved rails carry it a few degrees around the inside of the dome.

* * *

>no
Good call. You're already on the verge of impending mental collapse; you don't need to feel worse. You avoid the mirror like it's a basilisk until you're overabundantly cleaner.
You make an earnest attempt to clean up. There's a lot of water and scraping, and it doesn't go well. You put concealer literally everywhere. You're just going to have to deal with the fact that there are colors on your face today that simply can't be corrected. Long pants are a foregone conclusion. You consider the surfeit of ways that mascara could go horribly wrong, and without a second thought you walk out of the room to your dresser. Nicer clothes will at least allow you to masquerade as a well-put-together human being.

>z
Time passes.

* * *

>look
Your Quarters
You return home. It's a standard-issue dwelling, designed for the unusually harsh conditions of the Terrace. It is made of many alloys of metal, and is joisted by slender titanium trusses. It's defining feature is the central, dome-shaped foyer from which the more traditional, rectangular rooms branch off.Your tattered backpack is here. You typically don't leave home without it. You've been using an old-style drafting table as a desk for as long as you've needed a desk. It's edged with a dented but sturdy aluminum frame. It has a hefty steel pivot, its arc stretching 135° or more. Four triangularly trussed legs extend to spherical rubber feet which match perfectly your dented floor. Your door leads out, and you can see it's bright outside through it's circular window. Curved rails carry it a few degrees around the inside of the dome.

>Az
That's not a verb I recognise.

>look
Your Quarters
You return home. It's a standard-issue dwelling, designed for the unusually harsh conditions of the Terrace. It is made of many alloys of metal, and is joisted by slender titanium trusses. It's defining feature is the central, dome-shaped foyer from which the more traditional, rectangular rooms branch off.Your tattered backpack is here. You typically don't leave home without it. You've been using an old-style drafting table as a desk for as long as you've needed a desk. It's edged with a dented but sturdy aluminum frame. It has a hefty steel pivot, its arc stretching 135° or more. Four triangularly trussed legs extend to spherical rubber feet which match perfectly your dented floor. Your door leads out, and you can see it's bright outside through it's circular window. Curved rails carry it a few degrees around the inside of the dome.

>end
That's not a verb I recognise.

* * *

>z
Time passes.

>n
Good call. You're already on the verge of impending mental collapse; you don't need to feel worse. You avoid the mirror like it's a basilisk until you're overabundantly cleaner.
You make an earnest attempt to clean up. There's a lot of water and scraping, and it doesn't go well. You put concealer literally everywhere. You're just going to have to deal with the fact that there are colors on your face today that simply can't be corrected. Long pants are a foregone conclusion. You consider the surfeit of ways that mascara could go horribly wrong, and without a second thought you walk out of the room to your dresser. Nicer clothes will at least allow you to masquerade as a well-put-together human being.

I beg your pardon?

>look
Your Quarters
It's a standard-issue dwelling, designed for the unusually harsh conditions of the Terrace. It is made of many alloys of metal, and is joisted by slender titanium trusses. It's defining feature is the central, dome-shaped foyer from which the more traditional, rectangular rooms branch off.Your tattered backpack is here. You typically don't leave home without it. You've been using an old-style drafting table as a desk for as long as you've needed a desk. It's edged with a dented but sturdy aluminum frame. It has a hefty steel pivot, its arc stretching 135° or more. Four triangularly trussed legs extend to spherical rubber feet which match perfectly your dented floor. Your door leads out, and you can see it's bright outside through it's circular window. Curved rails carry it a few degrees around the inside of the dome.

* * *

>z
Time passes.

>no
Good call. You're already on the verge of impending mental collapse; you don't need to feel worse. You avoid the mirror like it's a basilisk until you're overabundantly cleaner.
You make an earnest attempt to clean up. There's a lot of water and scraping, and it doesn't go well. You put concealer literally everywhere. You're just going to have to deal with the fact that there are colors on your face today that simply can't be corrected. Long pants are a foregone conclusion. You consider the surfeit of ways that mascara could go horribly wrong, and without a second thought you walk out of the room to your dresser. Nicer clothes will at least allow you to masquerade as a well-put-together human being.

* * *

>z
Time passes.

You shudder awake. If you were a bit more careful (rather, if the room was spinning even a little bit slower), you might've dodged the doorframe on your way to your porcelain friend. You won't remember why your temple hurts. You begin to get up, but the visceral stack of mistakes you're popping off keep you down. You stagger to your feet, swaying a bit as you try to lock eyes with yourself in the mirror. Your eyes haven't focused yet, and you consider that you might not want to see yourself like this.

Do you look at yourself?

* * *

>look
Your Quarters
It's a standard-issue dwelling, designed for the unusually harsh conditions of the Terrace. It is made of many alloys of metal, and is joisted by slender titanium trusses. It's defining feature is the central, dome-shaped foyer from which the more traditional, rectangular rooms branch off.Your tattered backpack is here. You typically don't leave home without it. You've been using an old-style drafting table as a desk for as long as you've needed a desk. It's edged with a dented but sturdy aluminum frame. It has a hefty steel pivot, its arc stretching 135° or more. Four triangularly trussed legs extend to spherical rubber feet which match perfectly your dented floor. Your door leads out, and you can see it's bright outside through it's circular window. Curved rails carry it a few degrees around the inside of the dome. 

You shudder awake. If you were a bit more careful (rather, if the room was spinning even a little bit slower), you might've dodged the doorframe on your way to your porcelain friend. You won't remember why your temple hurts. You begin to get up, but the visceral stack of mistakes you're popping off keep you down. You stagger to your feet, swaying a bit as you try to lock eyes with yourself in the mirror. Your eyes haven't focused yet, and you consider that you might not want to see yourself like this.

Do you look at yourself?

* * *

>lok
That's not a verb I recognise.

>z
Time passes.

* * *

>f
That's not a verb I recognise.

Are you male or female?

>f
That's not a verb I recognise.

Are you male or female?

* * *

>Ada
Are you male or female?

>look
Your Quarters
You return home. It's a standard-issue dwelling, designed for the unusually harsh conditions of the Terrace. It is made of many alloys of metal, and is joisted by slender titanium trusses. It's defining feature is the central, dome-shaped foyer from which the more traditional, rectangular rooms branch off.Your tattered backpack is here. You typically don't leave home without it. You've been using an old-style drafting table as a desk for as long as you've needed a desk. It's edged with a dented but sturdy aluminum frame. It has a hefty steel pivot, its arc stretching 135° or more. Four triangularly trussed legs extend to spherical rubber feet which match perfectly your dented floor. Your door leads out, and you can see it's bright outside through it's circular window. Curved rails carry it a few degrees around the inside of the dome.

>z
Time passes.

* * *

>Ada
Are you male or female?

>adf
That's not a verb I recognise.

What will your name be?

* * *

What will your name be?

>ad
That's not a verb I recognise.

What will your name be?

>f
That's not a verb I recognise.

What will your name be?

* * *

What will your name be?

>look
Are you male or female?

>z
Time passes.

Are you male or female?