Rosy mist departs around a falling man. An extravagant bit of kinematics closes his fate tightly. The edge of the canyon's shadow dances along uneven crags, casting a sharp shadow between lines of scarlet and thulian, tracing down through cracks by a man now crumpled into a outcropped ravine. Some of the onlookers squirm at the sight, while others are quite a bit more moved by it. Before too long, and after the catwalk underwent a good scrubbing down by the real heroes in this situation, the crowd thinned. There was obviously nothing to be done for the poor man, so many began to leave the platform, in disgust or boredom.

One woman didn't leave. She stood, transfixed by the coral and mauve blood on the rocks, and the sunset of rainbows falling on the canyon. From that evening on, she had them glowing within her, she had his colors in her blood, too. From that evening on, varicolored palettes of light would race through her mind, the tones and shades of which she would keep for the rest of her days. Gentiana, getting impatient, prodded at her friend. "Adaline, let's go." Gentiana had given her more than enough time to get out of her trance, and it was getting late. "Come on, Adaline, we have to go." Adaline absentmindedly stumbled away with her, as a ragged moon began it's path up through the sky.

You shudder awake. If you were a bit more careful, that is, if the room was spinning even a little bit slower, you might have dodged the doorframe on your way to your porcelain friend. You won't remember why your temple hurts, anyways. You seem to wake up, again, with your face as cold as death, in the grime of the tile floor. Your stomach lining tastes different today. You begin to get up, but then the visceral stack of mistakes you're popping draw your attention. This drawn-out agony you're in, boy. If she hadn't've left last month, you're pretty sure none of this would have happened to you. It just got to be really bad about a week after she came home like... you don't really know what was wrong with her. Her really odd behaviour started that day, and just like hers, your little nightmare never really went away. It's too far apart: the dopamine rush is so delayed, it's so far away from the agony that Pavlov really can't help you out. You stagger to your feet, swaying a bit as you try to lock eyes with yourself in the mirror. Your eyes haven't focused yet, and you consider that you might not want to look at yourself like this.

Do you look at yourself?

>n
You can only go northeast, south, southeast, and southwest.

>se
Cliff's Edge
There's enough of a wind coming up the edge of the cliff to lift a small animal. Looking down over the white and vaguely purple chalk, you see an isolated cove, locked on two sides by tall rocks. There is a sand dune in front of a ravine-like opening, which seems to run under the cliffs somewhere to the north.

In a sandy depression at the edge of the cliff there is a cluster of flowers, wedged between grass and rock.

>look
Cliff's Edge
There's enough of a wind coming up the edge of the cliff to lift a small animal. Looking down over the white and vaguely purple chalk, you see an isolated cove, locked on two sides by tall rocks. There is a sand dune in front of a ravine-like opening, which seems to run under the cliffs somewhere to the north.

In a sandy depression at the edge of the cliff there is a cluster of flowers, wedged between grass and rock.

* * *

>n
You can only go northeast, south, southeast, and southwest.

>ne
Road to the Canyon's Stairway
By some wonder of igneous intrusion, the northern edge of the Terrace has a set of 6 stair-like stone batholiths, all following the Terrace's ragged edge. With one exception, they even descend in order. An amalgam of small shops and transportation businesses have made themselves right at home on the terrace surface, and a small residential sector spreads down to the first step.

>nw
You can't go that way.

>look
Road to the Canyon's Stairway
By some wonder of igneous intrusion, the northern edge of the Terrace has a set of 6 stair-like stone batholiths, all following the Terrace's ragged edge. With one exception, they even descend in order. An amalgam of small shops and transportation businesses have made themselves right at home on the terrace surface, and a small residential sector spreads down to the first step.

>look
Road to the Canyon's Stairway
By some wonder of igneous intrusion, the northern edge of the Terrace has a set of 6 stair-like stone batholiths, all following the Terrace's ragged edge. With one exception, they even descend in order. An amalgam of small shops and transportation businesses have made themselves right at home on the terrace surface, and a small residential sector spreads down to the first step.

* * *

>l
Seaside Cliff
The seaside terrace is far enough above the patchy trees and dells to afford a remarkable view of the ocean and sky. A ragged moon dusts some drying marshes to the southwest, and to the west lies a cascade of lavender and mahogany flora, gushing from marble cliffsides.

>s
Outside Dwelling
Halfway to the edge of the plateau is a small, dome-like dwelling, with some paths running between it and a small garden behind it, and another area downhill. It is noisily rusted around the rounded main roof, but the seaside wind has somewhat polished the east hemisphere.

The front porthole appears to be locked. It is quite sturdy, and there is a sizeable wheel at it's center.

The pathways are girded by brass and iron railings, which are sturdily fastened to the herringbone pathways.

* * *

>z
Time passes.

>z
Time passes.

I beg your pardon?

* * *

>yes
Dear lord. It isn't quite a sobering experience, but it's reflective. You're emaciated, haggard, and you still have some of your stomach lining in the corner of your mouth. The esophageal burning went away within the first week or so, but even though your nerves are so burned that it only tickles, it's getting more persistent. The ruggedness ain't the sexy kind, either, you look veritably awful.

What will your name be?

* * *

>look
Your Quarters
 

Your tattered backpack is here. You typically don't leave home without it.

Your door is a lightweight sliding panel, heavy enough to stop the rocky winds, but light enough to have been moved here for you to live.

>look
Your Quarters
Your modest abode is a standard-issue dwelling, designed for the unusually harsh conditions that result from being so high up on the Terace. It is made of multiple alloys of metal, and consists of a central, dome-shaped room, and a number of other, more traditionally rectangular rooms branching off from it.

Your tattered backpack is here. You typically don't leave home without it.

Your door is a lightweight sliding panel, heavy enough to stop the rocky winds, but light enough to have been moved here for you to live.

>get backpack
Taken.

>look
Your Quarters
Your modest abode is a standard-issue dwelling, designed for the unusually harsh conditions that result from being so high up on the Terace. It is made of multiple alloys of metal, and consists of a central, dome-shaped room, and a number of other, more traditionally rectangular rooms branching off from it.

Your door is a lightweight sliding panel, heavy enough to stop the rocky winds, but light enough to have been moved here for you to live.

>x pack
You can't see any such thing.

* * *

>look
Seaside Cliff
The seaside terrace is far enough above the patchy trees and dells to afford a remarkable view of the ocean and sky. A ragged moon dusts some drying marshes to the southwest, and to the west lies a cascade of lavender and mahogany flora, gushing from marble cliffsides.

>s
Outside Dwelling
Halfway to the edge of the plateau is a small, dome-like dwelling, with some paths running between it and a small garden behind it, and another area downhill. It is noisily rusted around the rounded main roof, but the seaside wind has somewhat polished the east hemisphere.

The front porthole appears to be locked. It is quite sturdy, and there is a sizeable wheel at it's center.

The pathways are girded by brass and iron railings, which are sturdily fastened to the herringbone pathways.

* * *

>þ
Rosy mist departs around a falling man. An extravagant bit of kinematics closes his fate tightly. The edge of the canyon's shadow dances along uneven crags, casting a sharp shadow between lines of scarlet and thulian, tracing down through cracks by a man now crumpled into a outcropped ravine. Some of the onlookers squirm at the sight, while others are quite a bit more moved by it. Before too long, and after the catwalk underwent a good scrubbing down by the real heroes in this situation, the crowd thinned. There was obviously nothing to be done for the poor man, so many began to leave the platform, in disgust or boredom.

One woman didn't leave. She stood, transfixed by the coral and mauve blood on the rocks, and the sunset of rainbows falling on the canyon. From that evening on, she had them glowing within her, she had his colors in her blood, too. From that evening on, varicolored palettes of light would race through her mind, the tones and shades of which she would keep for the rest of her days. Gentiana, getting impatient, prodded at her friend. "Adaline, let's go." Gentiana had given her more than enough time to get out of her trance, and it was getting late. "Come on, Adaline, we have to go." Adaline absentmindedly stumbled away with her, as a ragged moon began it's path up through the sky.

You shudder awake. If you were a bit more careful, that is, if the room was spinning even a little bit slower, you might have dodged the doorframe on your way to your porcelain friend. You won't remember why your temple hurts, anyways. You seem to wake up, again, with your face as cold as death, in the grime of the tile floor. Your stomach lining tastes different today. You begin to get up, but then the visceral stack of mistakes you're popping draw your attention. This drawn-out agony you're in, boy. If she hadn't've left last month, you're pretty sure none of this would have happened to you. It just got to be really bad about a week after she came home like... you don't really know what was wrong with her. Her really odd behaviour started that day, and just like hers, your little nightmare never really went away. It's too far apart: the dopamine rush is so delayed, it's so far away from the agony that Pavlov really can't help you out. You stagger to your feet, swaying a bit as you try to lock eyes with yourself in the mirror. Your eyes haven't focused yet, and you consider that you might not want to look at yourself like this.

Do you look at yourself?

I beg your pardon?

>look
Seaside Cliff
The seaside terrace is far enough above the patchy trees and dells to afford a remarkable view of the ocean and sky. A ragged moon dusts some drying marshes to the southwest, and to the west lies a cascade of lavender and mahogany flora, gushing from marble cliffsides.

* * *

>s
Outside Dwelling
Halfway to the edge of the plateau is a small, dome-like dwelling, with some paths running between it and a small garden behind it, and another area downhill. It is noisily rusted around the rounded main roof, but the seaside wind has somewhat polished the east hemisphere.

The front porthole appears to be locked. It is quite sturdy, and there is a sizeable wheel at it's center.

The pathways are girded by brass and iron railings, which are sturdily fastened to the herringbone pathways.

>n
Seaside Cliff
The seaside terrace is far enough above the patchy trees and dells to afford a remarkable view of the ocean and sky. A ragged moon dusts some drying marshes to the southwest, and to the west lies a cascade of lavender and mahogany flora, gushing from marble cliffsides.

>s
Outside Dwelling
Halfway to the edge of the plateau is a small, dome-like dwelling, with some paths running between it and a small garden behind it, and another area downhill. It is noisily rusted around the rounded main roof, but the seaside wind has somewhat polished the east hemisphere.

The front porthole appears to be locked. It is quite sturdy, and there is a sizeable wheel at it's center.

The pathways are girded by brass and iron railings, which are sturdily fastened to the herringbone pathways.

>asdf
That's not a verb I recognise.

>look
Outside Dwelling
Halfway to the edge of the plateau is a small, dome-like dwelling, with some paths running between it and a small garden behind it, and another area downhill. It is noisily rusted around the rounded main roof, but the seaside wind has somewhat polished the east hemisphere.

The front porthole appears to be locked. It is quite sturdy, and there is a sizeable wheel at it's center.

The pathways are girded by brass and iron railings, which are sturdily fastened to the herringbone pathways.

>n
Seaside Cliff
The seaside terrace is far enough above the patchy trees and dells to afford a remarkable view of the ocean and sky. A ragged moon dusts some drying marshes to the southwest, and to the west lies a cascade of lavender and mahogany flora, gushing from marble cliffsides.

>look
Seaside Cliff
The seaside terrace is far enough above the patchy trees and dells to afford a remarkable view of the ocean and sky. A ragged moon dusts some drying marshes to the southwest, and to the west lies a cascade of lavender and mahogany flora, gushing from marble cliffsides.

>sw
Forest Overlook
At a gentle angle, the ocean-facing side of the plateau slides down to form a nice, shady spot beneath the trees. From here, the gargantuan arbors string all the way up above the raised rock of the terrace. There are tufts of branches almost within reach at the edge of the cliff.

Down along the cliff's edge, one of the more colorful trees seems to have dropped some round fruits to the canyon's surface.

>ne
Seaside Cliff
The seaside terrace is far enough above the patchy trees and dells to afford a remarkable view of the ocean and sky. A ragged moon dusts some drying marshes to the southwest, and to the west lies a cascade of lavender and mahogany flora, gushing from marble cliffsides.

>ne
Road to the Canyon's Stairway
By some wonder of igneous intrusion, the northern edge of the Terrace has a set of 6 stair-like stone batholiths, all following the Terrace's ragged edge. With one exception, they even descend in order. An amalgam of small shops and transportation businesses have made themselves right at home on the terrace surface, and a small residential sector spreads down to the first step.

>n
The Town of Harston
This little boomtown has dug itself into the hard sandstone surface of the Terrace. Most of the shops are brimming with life, and the stone streets have been worn to the bare rock by thick rubber wheels and the foot traffic of a very busy people. The stores to the east are so crowded that you'd likely be injured if you tried to buy something there, but the west end is quieter. There is a utilities shop to the west, a closed, nondescript shop to the southwest, and a cablecar service to the northwest.

>sw
You can only go northwest, south, and west.

>w
(first opening the Utility Shop Door)

Harold's Utility Store
A large, round man stands in a cacophony of fresh hiking supplies and tools which decrease in quality with the square of the distance from his admittedly long reach.

>look
Harold's Utility Store
A large, round man stands in a cacophony of fresh hiking supplies and tools which decrease in quality with the square of the distance from his admittedly long reach.

>e
The Town of Harston
This little boomtown has dug itself into the hard sandstone surface of the Terrace. Most of the shops are brimming with life, and the stone streets have been worn to the bare rock by thick rubber wheels and the foot traffic of a very busy people. The stores to the east are so crowded that you'd likely be injured if you tried to buy something there, but the west end is quieter. There is a utilities shop to the west, a closed, nondescript shop to the southwest, and a cablecar service to the northwest.

>s
Road to the Canyon's Stairway
By some wonder of igneous intrusion, the northern edge of the Terrace has a set of 6 stair-like stone batholiths, all following the Terrace's ragged edge. With one exception, they even descend in order. An amalgam of small shops and transportation businesses have made themselves right at home on the terrace surface, and a small residential sector spreads down to the first step.

* * *

>asdf
That's not a verb I recognise.

>look
Seaside Cliff
The seaside terrace is far enough above the patchy trees and dells to afford a remarkable view of the ocean and sky. A ragged moon dusts some drying marshes to the southwest, and to the west lies a cascade of lavender and mahogany flora, gushing from marble cliffsides.

>look
Seaside Cliff
The seaside terrace is far enough above the patchy trees and dells to afford a remarkable view of the ocean and sky. A ragged moon dusts some drying marshes to the southwest, and to the west lies a cascade of lavender and mahogany flora, gushing from marble cliffsides.

* * *

>asdf
That's not a verb I recognise.

>asdf
That's not a verb I recognise.

* * *

>look
Outside Dwelling
Halfway to the edge of the plateau is a small, dome-like dwelling, with some paths running between it and a small garden behind it, and another area downhill. It is noisily rusted around the rounded main roof, but the seaside wind has somewhat polished the east hemisphere.

The front porthole appears to be locked. It is quite sturdy, and there is a sizeable wheel at it's center.

The pathways are girded by brass and iron railings, which are sturdily fastened to the herringbone pathways.

>south
You can only go north and inside.

>look
Outside Dwelling
Halfway to the edge of the plateau is a small, dome-like dwelling, with some paths running between it and a small garden behind it, and another area downhill. It is noisily rusted around the rounded main roof, but the seaside wind has somewhat polished the east hemisphere.

The front porthole appears to be locked. It is quite sturdy, and there is a sizeable wheel at it's center.

The pathways are girded by brass and iron railings, which are sturdily fastened to the herringbone pathways.

>look
Outside Dwelling
Halfway to the edge of the plateau is a small, dome-like dwelling, with some paths running between it and a small garden behind it, and another area downhill. It is noisily rusted around the rounded main roof, but the seaside wind has somewhat polished the east hemisphere.

The front porthole appears to be locked. It is quite sturdy, and there is a sizeable wheel at it's center.

The pathways are girded by brass and iron railings, which are sturdily fastened to the herringbone pathways.

>s
You can only go north and inside.

>n
Seaside Cliff
The seaside terrace is far enough above the patchy trees and dells to afford a remarkable view of the ocean and sky. A ragged moon dusts some drying marshes to the southwest, and to the west lies a cascade of lavender and mahogany flora, gushing from marble cliffsides.

* * *

>s
Outside Dwelling
Halfway to the edge of the plateau is a small, dome-like dwelling, with some paths running between it and a small garden behind it, and another area downhill. It is noisily rusted around the rounded main roof, but the seaside wind has somewhat polished the east hemisphere.

The front porthole appears to be locked. It is quite sturdy, and there is a sizeable wheel at it's center.

The pathways are girded by brass and iron railings, which are sturdily fastened to the herringbone pathways.

>s
You can only go north and inside.

>l
Outside Dwelling
Halfway to the edge of the plateau is a small, dome-like dwelling, with some paths running between it and a small garden behind it, and another area downhill. It is noisily rusted around the rounded main roof, but the seaside wind has somewhat polished the east hemisphere.

The front porthole appears to be locked. It is quite sturdy, and there is a sizeable wheel at it's center.

The pathways are girded by brass and iron railings, which are sturdily fastened to the herringbone pathways.

>restart
Are you sure you want to restart?

Please answer yes or no.

* * *

>l
Your Quarters
 

Your tattered backpack is here. You typically don't leave home without it.

Your door is a lightweight sliding panel, heavy enough to stop the rocky winds, but light enough to have been moved here for you to live.

>restart
Are you sure you want to restart?

* * *

>l
Rosy mist departs around a falling man. An extravagant bit of kinematics closes his fate tightly. The edge of the canyon's shadow dances along uneven crags, casting a sharp shadow between lines of scarlet and thulian, tracing down through cracks by a man now crumpled into a outcropped ravine. Some of the onlookers squirm at the sight, while others are quite a bit more moved by it. Before too long, and after the catwalk underwent a good scrubbing down by the real heroes in this situation, the crowd thinned. There was obviously nothing to be done for the poor man, so many began to leave the platform, in disgust or boredom.

One woman didn't leave. She stood, transfixed by the coral and mauve blood on the rocks, and the sunset of rainbows falling on the canyon. From that evening on, she had them glowing within her, she had his colors in her blood, too. From that evening on, varicolored palettes of light would race through her mind, the tones and shades of which she would keep for the rest of her days. Gentiana, getting impatient, prodded at her friend. "Adaline, let's go." Gentiana had given her more than enough time to get out of her trance, and it was getting late. "Come on, Adaline, we have to go." Adaline absentmindedly stumbled away with her, as a ragged moon began it's path up through the sky.

>l
Vividity
An exercise in adventure puzzles and overwriting by Ben Scott
Release 1 / Serial number 150330 / Inform 7 build 6L38 (I6/v6.33 lib 6/12N) SD

Seaside Cliff
The seaside terrace is far enough above the patchy trees and dells to afford a remarkable view of the ocean and sky. A ragged moon dusts some drying marshes to the southwest, and to the west lies a cascade of lavender and mahogany flora, gushing from marble cliffsides. A serene breeze rolls over the terrace and eddies overtop the northwest trees, which are almost flush with the plateau.

>s
Outside Dwelling
Halfway to the edge of the plateau is a small, dome-like dwelling, with some paths running between it and a small garden behind it, and another area downhill. It is noisily rusted around the rounded main roof, but the seaside wind has somewhat polished the east hemisphere.

The front porthole appears to be locked. It is quite sturdy, and there is a sizeable wheel at it's center.

The pathways are girded by brass and iron railings, which are sturdily fastened to the herringbone pathways.

* * *

>n
Seaside Cliff
The seaside terrace is far enough above the patchy trees and dells to afford a remarkable view of the ocean and sky. A ragged moon dusts some drying marshes to the southwest, and to the west lies a cascade of lavender and mahogany flora, gushing from marble cliffsides.

>se
Cliff's Edge
There's enough of a wind coming up the edge of the cliff to lift a small animal. Looking down over the white and vaguely purple chalk, you see an isolated cove, locked on two sides by tall rocks. There is a sand dune in front of a ravine-like opening, which seems to run under the cliffs somewhere to the north.

In a sandy depression at the edge of the cliff there is a cluster of flowers, wedged between grass and rock.

>FUCK
That's not a verb I recognise.