Rosy mist departs around a falling man. An extravagant bit of kinematics closes his fate tightly, yet, all things considered, his fate was probably well-enough sealed already. The edge of the canyon's shadow dances along uneven crags, casting a sharp shadow between lines of scarlet and thulian, traced down through the cracks by the man crumpled into a outcropped ravine. Some of the onlookers squirmed at the sight, while others were quite a bit more moved by it. After too long, and after the catwalk was scrubbed down by the real heroes in this situation, the crowd began to thin. There was obviously nothing to be done for him, so many began to leave the platform in disgust or boredom.

One woman didn't leave. She stood, transfixed by the coral and mauve blood on the rocks, and the sunset of rainbows falling on the canyon. From that evening on, she had them glowing within her, she had his colors in her blood, too. From that evening on, varicolored palettes of light would race through her mind, the tones and shades of which she would keep for the rest of her days. Gentiana, getting impatient, prodded at her friend. "Adaline, let's go." Gentiana had given her more than enough time to get out of her trance, and it was getting late. "Come on, Adaline, we have to go." Adaline absentmindedly stumbled away with her, as a ragged moon began it's path up through the sky.

What will your name be?

* * *

>Ada
Are you male or female?

>f
Seaside Cliff
The seaside terrace is far enough above the patchy trees and dells to afford a remarkable view of the ocean and sky. A ragged moon dusts some drying marshes to the west, and to the northwest lies a cascade of lavender and mahogany flora, gushing from marble cliffsides. A serene breeze rolls over the terrace and eddies overtop the northeast trees, which are almost flush with the plateau.

A leaflet is held down by a rock, an edge fluttering in the breeze.

>se
Cliff's Edge
There's enough of a wind coming up the edge of the cliff to lift a small animal. Looking down over the white and vaguely purple chalk, you see an isolated cove, locked on two sides by tall rocks. There is a sand dune in front of a ravine-like opening, which seems to run under the cliffs somewhere to the north.

>l flower
You see nothing special about the small quantity of flower.

>get flower
Taken.

>g
You already have that.

>i
You are carrying:
  a small quantity of flower

>get flower
You already have that.

>count flower
That's not a verb I recognise.

>x flower
You see nothing special about the small quantity of flower.

>x flower
You see nothing special about the mystery flower.

>i
You are carrying:
  a mystery flower

>x flower
You see nothing special about the mystery flower.

>x flower
You see nothing special about the mystery flower.

>eat it
You eat some of the flower. It's sweetly salty, and tingles your tongue. Before you're able to fully swallow all the petals, your heartrate doubles, and your mouth gets dry. You stumble around a bit.

>se
The only way out is northwest.

>sw
The only way out is northwest.

>nw
Seaside Cliff
The seaside terrace is far enough above the patchy trees and dells to afford a remarkable view of the ocean and sky. A ragged moon dusts some drying marshes to the west, and to the northwest lies a cascade of lavender and mahogany flora, gushing from marble cliffsides.

A leaflet is held down by a rock, an edge fluttering in the breeze.

You're elated now, and you're getting uncomfortably tachycardic.

>s
Outside Dwelling
Halfway to the edge of the plateau is a small, dome-like dwelling, with some paths running between it and a small garden behind it, and another area downhill. It is noisily rusted around the rounded main roof, but the seaside wind has somewhat polished the east hemisphere.

The front porthole appears to be locked. It is quite sturdy, and there is a sizeable wheel at it's center.

The pathways are girded by brass and iron railings, which are sturdily fastened to the herringbone pathways.

>n
Seaside Cliff
The seaside terrace is far enough above the patchy trees and dells to afford a remarkable view of the ocean and sky. A ragged moon dusts some drying marshes to the west, and to the northwest lies a cascade of lavender and mahogany flora, gushing from marble cliffsides.

A leaflet is held down by a rock, an edge fluttering in the breeze.

>south
Outside Dwelling
Halfway to the edge of the plateau is a small, dome-like dwelling, with some paths running between it and a small garden behind it, and another area downhill. It is noisily rusted around the rounded main roof, but the seaside wind has somewhat polished the east hemisphere.

The front porthole appears to be locked. It is quite sturdy, and there is a sizeable wheel at it's center.

The pathways are girded by brass and iron railings, which are sturdily fastened to the herringbone pathways.

You fall over twitching. Your heart feels like it's deflating, sloppily pushing blood all over the place, and skipping more and more beats. You tingle and twitch as your entire body is deprived of oxygen. You struggle back to your feet.

* * *

>f
Seaside Cliff
The seaside terrace is far enough above the patchy trees and dells to afford a remarkable view of the ocean and sky. A ragged moon dusts some drying marshes to the west, and to the northwest lies a cascade of lavender and mahogany flora, gushing from marble cliffsides. A serene breeze rolls over the terrace and eddies overtop the northeast trees, which are almost flush with the plateau.

A leaflet is held down by a rock, an edge fluttering in the breeze.

I beg your pardon?

>se
Cliff's Edge
There's enough of a wind coming up the edge of the cliff to lift a small animal. Looking down over the white and vaguely purple chalk, you see an isolated cove, locked on two sides by tall rocks. There is a sand dune in front of a ravine-like opening, which seems to run under the cliffs somewhere to the north.

In a sandy depression at the edge of the cliff there is a cluster of flowers, wedged between grass and rock.

>get flowers
Taken.

>eat one
You can't see any such thing.

>eat them
I'm not sure what 'them' refers to.

>eat flowers
You eat one of the flowers. It's sweetly salty, and tingles your tongue. Before you're able to swallow all the petals, your heartrate doubles, and your mouth gets dry. You stumble around a bit.

>i
You are carrying nothing.

* * *

What will your name be?

>ada
Are you male or female?

>l
Are you male or female?

>f
Seaside Cliff
The seaside terrace is far enough above the patchy trees and dells to afford a remarkable view of the ocean and sky. A ragged moon dusts some drying marshes to the west, and to the northwest lies a cascade of lavender and mahogany flora, gushing from marble cliffsides.A serene breeze rolls over the terrace and eddies overtop the northeast trees, which are almost flush with the plateau.

A leaflet is held down by a rock, an edge fluttering in the breeze.

* * *

>ada
Are you male or female?

>f
Seaside Cliff
The seaside terrace is far enough above the patchy trees and dells to afford a remarkable view of the ocean and sky. A ragged moon dusts some drying marshes to the west, and to the northwest lies a cascade of lavender and mahogany flora, gushing from marble cliffsides. A serene breeze rolls over the terrace and eddies overtop the northeast trees, which are almost flush with the plateau.

A leaflet is held down by a rock, an edge fluttering in the breeze.

>se
Cliff's Edge
There's enough of a wind coming up the edge of the cliff to lift a small animal. Looking down over the white and vaguely purple chalk, you see an isolated cove, locked on two sides by tall rocks. There is a sand dune in front of a ravine-like opening, which seems to run under the cliffs somewhere to the north.

In a sandy depression at the edge of the cliff there is a cluster of flowers, wedged between grass and rock.

>i
You are carrying:
  a backpack (being worn, and open but empty)

>get flower
You can't see any such thing.

>get flowers
Taken.

>i
You are carrying:
  5 flowers
  a backpack (being worn, and open but empty)

>put flowers in pack
You can't see any such thing.

>put flowers in backpack
You put 5 flowers into the backpack.

>get one flower
You can't see any such thing.

>get flowers
Taken.

>eat flowers
You eat one of the flowers. It's sweetly salty, and tingles your tongue. Before you're able to swallow all the petals, your heartrate doubles, and your mouth gets dry. You stumble around a bit.

>i
You are carrying:
  4 mystery flowers
  a backpack (being worn, and open but empty)

* * *

>se
Cliff's Edge
There's enough of a wind coming up the edge of the cliff to lift a small animal. Looking down over the white and vaguely purple chalk, you see an isolated cove, locked on two sides by tall rocks. There is a sand dune in front of a ravine-like opening, which seems to run under the cliffs somewhere to the north.

In a sandy depression at the edge of the cliff there is a cluster of flowers, wedged between grass and rock.

>get flowers. eat flowers
Taken.

You eat one of the flowers. It's sweetly salty, and tingles your tongue. Before you're able to swallow all the petals, your heartrate doubles, and your mouth gets dry. You stumble around a bit.

>i
You are carrying:
  4 mystery flowers

>z
Time passes.

>z
Time passes.

You're elated now, and you're getting uncomfortably tachycardic.

>i
You are carrying:
  4 mystery flowers

* * *

>z
Time passes.

>z
Time passes.

You fall over twitching. Your heart feels like it's deflating, sloppily sending blood all over the place, and skipping more and more beats. You tingle and twitch as your entire body is deprived of oxygen. You struggle back to your feet.

>i
You are carrying:
  4 mystery flowers

>eat flowers
You eat one of the flowers. It's sweetly salty, and tingles your tongue. Before you're able to swallow all the petals, your heartrate doubles, and your mouth gets dry. You stumble around a bit.

    *** Your heart rolls to a stop as you slip into death with your whole body humming. ***

Would you like to RESTART, RESTORE a saved game, QUIT, or UNDO the last command?

* * *

What will your name be?

>Adaline Braun
Are you male or female?

>f
Seaside Cliff
The seaside terrace is far enough above the patchy trees and dells to afford a remarkable view of the ocean and sky. A ragged moon dusts some drying marshes to the west, and to the northwest lies a cascade of lavender and mahogany flora, gushing from marble cliffsides. A serene breeze rolls over the terrace and eddies overtop the northeast trees, which are almost flush with the plateau.

A leaflet is held down by a rock, an edge fluttering in the breeze.

* * *

>Adaline Braun
Are you male or female?

>j
That's not a verb I recognise.

Are you male or female?

>f
Seaside Cliff
The seaside terrace is far enough above the patchy trees and dells to afford a remarkable view of the ocean and sky. A ragged moon dusts some drying marshes to the west, and to the northwest lies a cascade of lavender and mahogany flora, gushing from marble cliffsides. A serene breeze rolls over the terrace and eddies overtop the northeast trees, which are almost flush with the plateau.

A leaflet is held down by a rock, an edge fluttering in the breeze.

>se
Cliff's Edge
There's enough of a wind coming up the edge of the cliff to lift a small animal. Looking down over the white and vaguely purple chalk, you see an isolated cove, locked on two sides by tall rocks. There is a sand dune in front of a ravine-like opening, which seems to run under the cliffs somewhere to the north.

In a sandy depression at the edge of the cliff there is a flower, wedged between grass and rock.

>get flower
Taken.

>i
You are carrying:
  a small quantity of flower

>l
Cliff's Edge
There's enough of a wind coming up the edge of the cliff to lift a small animal. Looking down over the white and vaguely purple chalk, you see an isolated cove, locked on two sides by tall rocks. There is a sand dune in front of a ravine-like opening, which seems to run under the cliffs somewhere to the north.

>eat flower
You eat some of the flower. It's sweetly salty, and tingles your tongue. Before you're able to fully swallow all the petals, your heartrate doubles, and your mouth gets dry. You stumble around a bit.

>l
Cliff's Edge
There's enough of a wind coming up the edge of the cliff to lift a small animal. Looking down over the white and vaguely purple chalk, you see an isolated cove, locked on two sides by tall rocks. There is a sand dune in front of a ravine-like opening, which seems to run under the cliffs somewhere to the north.

>i
You are carrying:
  a half-eaten mystery flower

>i
You are carrying:
  a half-eaten mystery flower

You're elated now, and you're getting uncomfortably tachycardic.

>eat flower
You eat some of the flower. It's sweetly salty, and tingles your tongue. Before you're able to fully swallow all the petals, your heartrate doubles, and your mouth gets dry. You stumble around a bit.

* * *

>l
Cliff's Edge
There's enough of a wind coming up the edge of the cliff to lift a small animal. Looking down over the white and vaguely purple chalk, you see an isolated cove, locked on two sides by tall rocks. There is a sand dune in front of a ravine-like opening, which seems to run under the cliffs somewhere to the north.

>i
You are carrying:
  a half-eaten mystery flower

You fall over twitching. Your heart feels like it's deflating, beating sideways, skipping more and more beats. You tingle and twitch as your entire body is deprived of oxygen. You struggle back to your feet.

* * *

>asdf
That's not a verb I recognise.

Are you male or female?

* * *

>þ
Rosy mist departs around a falling man. An extravagant bit of kinematics closes his fate tightly, yet, all things considered, his fate was probably well-enough sealed already. The edge of the canyon's shadow dances along uneven crags, casting a sharp shadow between lines of scarlet and thulian, traced down through the cracks by the man crumpled into a outcropped ravine. Some of the onlookers squirmed at the sight, while others were quite a bit more moved by it. After too long, and after the catwalk was scrubbed down by the real heroes in this situation, the crowd began to thin. There was obviously nothing to be done for him, so many began to leave the platform in disgust or boredom.

One woman didn't leave. She stood, transfixed by the coral and mauve blood on the rocks, and the sunset of rainbows falling on the canyon. From that evening on, she had them glowing within her, she had his colors in her blood, too. From that evening on, varicolored palettes of light would race through her mind, the tones and shades of which she would keep for the rest of her days. Gentiana, getting impatient, prodded at her friend. "Adaline, let's go." Gentiana had given her more than enough time to get out of her trance, and it was getting late. "Come on, Adaline, we have to go." Adaline absentmindedly stumbled away with her, as a ragged moon began it's path up through the sky.

Please press SPACE to continue.

Rosy mist departs around a falling man. An extravagant bit of kinematics closes his fate tightly, yet, all things considered, his fate was probably well-enough sealed already. The edge of the canyon's shadow dances along uneven crags, casting a sharp shadow between lines of scarlet and thulian, traced down through the cracks by the man crumpled into a outcropped ravine. Some of the onlookers squirmed at the sight, while others were quite a bit more moved by it. After too long, and after the catwalk was scrubbed down by the real heroes in this situation, the crowd began to thin. There was obviously nothing to be done for him, so many began to leave the platform in disgust or boredom.

One woman didn't leave. She stood, transfixed by the coral and mauve blood on the rocks, and the sunset of rainbows falling on the canyon. From that evening on, she had them glowing within her, she had his colors in her blood, too. From that evening on, varicolored palettes of light would race through her mind, the tones and shades of which she would keep for the rest of her days. Gentiana, getting impatient, prodded at her friend. "Adaline, let's go." Gentiana had given her more than enough time to get out of her trance, and it was getting late. "Come on, Adaline, we have to go." Adaline absentmindedly stumbled away with her, as a ragged moon began it's path up through the sky.

Please press SPACE to continue.

What will your name be?

* * *

>f
Seaside Cliff
The seaside terrace is far enough above the patchy trees and dells to afford a remarkable view of the ocean and sky. A ragged moon dusts some drying marshes to the west, and to the northwest lies a cascade of lavender and mahogany flora, gushing from marble cliffsides. A serene breeze rolls over the terrace and eddies overtop the northeast trees, which are almost flush with the plateau.

A leaflet is held down by a rock, an edge fluttering in the breeze.

>i
You are carrying nothing.

>l
Seaside Cliff
The seaside terrace is far enough above the patchy trees and dells to afford a remarkable view of the ocean and sky. A ragged moon dusts some drying marshes to the west, and to the northwest lies a cascade of lavender and mahogany flora, gushing from marble cliffsides.

A leaflet is held down by a rock, an edge fluttering in the breeze.

>se
Cliff's Edge
There's enough of a wind coming up the edge of the cliff to lift a small animal. Looking down over the white and vaguely purple chalk, you see an isolated cove, locked on two sides by tall rocks. There is a sand dune in front of a ravine-like opening, which seems to run under the cliffs somewhere to the north.

In a sandy depression at the edge of the cliff there is a cluster of flowers, wedged between grass and rock.

>nw
Seaside Cliff
The seaside terrace is far enough above the patchy trees and dells to afford a remarkable view of the ocean and sky. A ragged moon dusts some drying marshes to the west, and to the northwest lies a cascade of lavender and mahogany flora, gushing from marble cliffsides.

A leaflet is held down by a rock, an edge fluttering in the breeze.

>get backpack
You can't see any such thing.

* * *

>Adaline Braun
That's not a verb I recognise.

What will your name be?

>male
That's not a verb I recognise.

>male
That's not a verb I recognise.

Are you male or female?

I beg your pardon?

Are you male or female?

>adsf
That's not a verb I recognise.

Are you male or female?

>female
That's not a verb I recognise.

Are you male or female?

* * *

>Adaline Braun
That's not a verb I recognise.

What will your name be?

>female
That's not a verb I recognise.

* * *

>Adaline Braun
That's not a verb I recognise.

What will your name be?

>Female
That's not a verb I recognise.

>Adaline Braun
That's not a verb I recognise.

>adlkf
That's not a verb I recognise.

* * *

>Adaline Braun
That's not a verb I recognise.

What will your name be?

>Cane
That's not a verb I recognise.

What will your name be?

>l
Seaside Cliff
A serene breeze rolls over the terrace and eddies overtop the northeast trees, which are almost flush with the plateau.

A leaflet is held down by a rock, an edge fluttering in the breeze.

What will your name be?

* * *

Rosy mist departs around a falling man. An extravagant bit of kinematics closes his fate tightly, yet, all things considered, his fate was probably well-enough sealed already. The edge of the canyon's shadow dances along uneven crags, casting a sharp shadow between lines of scarlet and thulian, traced down through the cracks by the man crumpled into a outcropped ravine. Some of the onlookers squirmed at the sight, while others were quite a bit more moved by it. After too long, and after the catwalk was scrubbed down by the real heroes in this situation, the crowd began to thin. There was obviously nothing to be done for him, so many began to leave the platform in disgust or boredom.

One woman didn't leave. She stood, transfixed by the coral and mauve blood on the rocks, and the sunset of rainbows falling on the canyon. From that evening on, she had them glowing within her, she had his colors in her blood, too. From that evening on, varicolored palettes of light would race through her mind, the tones and shades of which she would keep for the rest of her days. Gentiana, getting impatient, prodded at her friend. "Adaline, let's go." Gentiana had given her more than enough time to get out of her trance, and it was getting late. "Come on, Adaline, we have to go." Adaline absentmindedly stumbled away with her, as a ragged moon began it's path up through the sky.

Please press SPACE to continue.

* * *

>i
You are carrying:
  a small quantity of flower

>eat it
You eat some of the flower. It's sweetly salty, and tingles your tongue. Before you're able to fully swallow all the petals, your heartrate doubles, and your mouth gets dry. You stumble around a bit.

>l
Cliff's Edge
There's enough of a wind coming up the edge of the cliff to lift a small animal. Looking down over the white and vaguely purple chalk, you see an isolated cove, locked on two sides by tall rocks. There is a sand dune in front of a ravine-like opening, which seems to run under the cliffs somewhere to the north.

>i
You are carrying nothing.

>l
Cliff's Edge
There's enough of a wind coming up the edge of the cliff to lift a small animal. Looking down over the white and vaguely purple chalk, you see an isolated cove, locked on two sides by tall rocks. There is a sand dune in front of a ravine-like opening, which seems to run under the cliffs somewhere to the north.

You're elated now, and you're getting uncomfortably tachycardic.

>l
Cliff's Edge
There's enough of a wind coming up the edge of the cliff to lift a small animal. Looking down over the white and vaguely purple chalk, you see an isolated cove, locked on two sides by tall rocks. There is a sand dune in front of a ravine-like opening, which seems to run under the cliffs somewhere to the north.

>l
Cliff's Edge
There's enough of a wind coming up the edge of the cliff to lift a small animal. Looking down over the white and vaguely purple chalk, you see an isolated cove, locked on two sides by tall rocks. There is a sand dune in front of a ravine-like opening, which seems to run under the cliffs somewhere to the north.

>l
Cliff's Edge
There's enough of a wind coming up the edge of the cliff to lift a small animal. Looking down over the white and vaguely purple chalk, you see an isolated cove, locked on two sides by tall rocks. There is a sand dune in front of a ravine-like opening, which seems to run under the cliffs somewhere to the north.

You fall over twitching. Your heart feels like it's deflating, beating sideways, skipping more and more beats. You tingle and twitch as your entire body is deprived of oxygen. You struggle back to your feet.

>l
Cliff's Edge
There's enough of a wind coming up the edge of the cliff to lift a small animal. Looking down over the white and vaguely purple chalk, you see an isolated cove, locked on two sides by tall rocks. There is a sand dune in front of a ravine-like opening, which seems to run under the cliffs somewhere to the north.

>l
Cliff's Edge
There's enough of a wind coming up the edge of the cliff to lift a small animal. Looking down over the white and vaguely purple chalk, you see an isolated cove, locked on two sides by tall rocks. There is a sand dune in front of a ravine-like opening, which seems to run under the cliffs somewhere to the north.

    *** Your heart rolls to a stop, and you slip into blackness with your whole body humming. ***

Would you like to RESTART, RESTORE a saved game, QUIT, or UNDO the last command?

>undo
Cliff's Edge
[Previous turn undone.]

>l flower
You can't see any such thing.

>i
You are carrying nothing.

    *** Your heart rolls to a stop, and you slip into blackness with your whole body humming. ***

Would you like to RESTART, RESTORE a saved game, QUIT, or UNDO the last command?

>undo
Cliff's Edge
[Previous turn undone.]

>l
Cliff's Edge
There's enough of a wind coming up the edge of the cliff to lift a small animal. Looking down over the white and vaguely purple chalk, you see an isolated cove, locked on two sides by tall rocks. There is a sand dune in front of a ravine-like opening, which seems to run under the cliffs somewhere to the north.

    *** Your heart rolls to a stop, and you slip into blackness with your whole body humming. ***

Would you like to RESTART, RESTORE a saved game, QUIT, or UNDO the last command?